0001000011
1100011111
1110110001
1000110101
1011110101
1000000101
1110110101
1100110101
1000001101
0011111101