11111111111
10001000011
11100011111
10110110001
10000110101
11011110101
11000000101
11110110101
10100110101
10000001101
11111111101
